WelcomeMessage=I wanna play Dungeons & Dragons
StartMessage=Why do you wanna play?
DontLikeFantasyMessage=You don't want play DnD, you want to play something else
DontPlayDNDMessage=Now you are vampyre, I hope you are happy
SpecialHeroMessage=Every hero is special. What makes you special?
ClassicFantasyMessage=Sure, I like the classic fantasy races anyways
WhatMakesSpecialMessage=Ugh, FINE. What makes you so special then?
DarkWhiteDudeMessage=Seriosly, you could just like, be a dark or brooding white dude
DragonMessage=You can't be a dragon
PickColorMessage=FINE PICK YOUR FAVORITE COLOR
DragonbornMessage=DRAGONBORN (PHB)
CloseEnoughMessage=Close enough
GetOutMessage=Ugh, just get out
KoboldMessage=KOBOLD (Volos)
KindOfMonstrousMessage=Okay, well we got options. Are you actually kind of monstrous or just misunderstood
ComicReliefMessage=Great! How do you feel about comic relief?
ScalesMessage=Fun-sized evil it is. How do you feel about Scales?
PowerMessage=Right. Sorry. What is power to you
GoblinMessage=GOBLIN (Volos)
SurpriseAttackMessage=Surprise attack or face the enemy head on because you're not a coward
ABitOfStrengthMessage=But a bit of strength is needed too right? To conquer?
YuanTiMessage=YUAN-TI (Volos)
bugbearMessage=BUGBEAR (Volos)
hobgoblinMessage=HOBGOBLIN (Volos)
orcMessage=ORC (Volos)
VersionMessage=Big version or Small version?
AnimalPersonMessage=Wow. That's helpful. Is Animal Person weird enough for you?
WeirdWeirdsMessage=Are you just looking for weird for weird's sake at this point?
UncommonRacesMessage=Uncommon Races! What sounds appealing to you?
PartOfMonsterMessage=Yup! Do you want to go part of the way or all the way
furryMessage=Are you a furry?
ChangelingsMessage=CHANGELINGS (Eberron)
WarforgedMessage=WARFORGED (Eberron)
TritonMessage=TRITON (Volos)
SeaElfMessage=SEA ELF (Elf Subrace)
AasimarMessage=AASIMAR (Volos)
KindOfAngelMessage=More choices! What kind of angel?
ProtectorMessage=PROTECTOR (Aasimar Subrace)
ScourgeMessage=SCOURGE (Aasimar Subrace)
FallenMessage=FALLEN (Aasimar Subrace)
PeopleMisunderstandnMessage=Alright why do people misunderstand you
HalfOrcMessage=HALF-ORC (PHB)
TieFlingMessage=TIEFLING (PHB)
TedCruzMessage=Like Ted Cruz. Neat. So what kind of scales we talking?
lizardfolkMessage=LIZARDFOLK (Volos)
humanMessage=HUMAN (PHB)
whatisitMessage=Ugh what is it
HalfMonsterMessage=Alright. Are you half monstrous or half magical and pretty?
halfelfMessage=HALF-ELF (PHB)
EdgelordMessage=Cool, we actually have those if you picked that path earlier you edgelord
duegarMessage=DUEGAR (Dwarf Subrace)
DrowMessage=DROW (Elf Subrace)
ShadarKaiMessage=SHADAR-KAI (Elf Subrace)
HumanSizedMessage=Nice! Wanna be human sized or tiny?
StronkMenMessage=...Sure. More of the Gentle Nature Giant or STRONK MEN
firbolgMessage=FIRBOLG (Volos)
goliathMessage=GOLIATH (Volos)
nPrettynSwoleMessage=Lithe 'n' Pretty or Short 'n' Swole?
LessClassicMessage=Sure, but we're getting less classic now
DwarfMessage=DWARF (PHB)
HillsOrStrongerMessage=So, are you hardier like the hills, or stronger like stone?
HillDwarfMessage=HILL DWARF (Dwarf Subrace)
MountainDwarfMessage=MOUNTAIN DWARF (Dwarf Subrace)
ElfMessage=ELF (PHB)
GetsComplicatedMessage=Wait, now it gets complicated. Is magic or nature more important for you?
HighElfMessage=HIGH ELF (Elf Subrace)
WoodElfMessage=WOOD ELF (Elf Subrace)
WhatsTheProblemMessage=What? Fine. What's the problem?
EladrinMessage=ELADRIN (Elf Subrace)
ExtremelySillyMessage=Alright, are you only a bit silly or extremely silly?
halflingMessage=HALFLING (PHB)
DwarfyOrNumbleMessage=Not done yet. Want to be slightly dwarfy or nimble?
stoutMessage=STOUT (Halfling Subrace)
lightfootMessage=LIGHTFOOT (Halfling Subrace)
gnomeMessage=GNOME (PHB)
TricksterMessage=You can be a woodsy trickster or steampunk tinkerer
ForestGnomeMessage=FOREST GNOME (Gnome Subrace)
MountainGnomeMessage=MOUNTAIN GNOME (Gnome Subrace)
DeepGnomeMessage=DEEP GNOME (Gnome Subrace)
CentaurMessage=CENTAUR (GGtR)
fursonaMessage="sigh" What's your fursona
TabaxiMessage=TABAXI (Volos)
MinotaurMessage=MINOTAUR (GGtR)
LoxadonMessage=LOXADON (GGtR)
ShifterMessage=SHIFTER (Eberron)
EagleOrCorvidMessage=Majestic Eagle or Obnoxious Corvid?
AarakocraMessage=AARAKOCRA (Elemental Evil)
KenkuMessage=KENKU (Volos)
ParentGenieMessage=Ugh fine. One of your parents is a genie
MultiverseDwellingMessage=Seriously? How about multiverse dwelling psionic plane hoppers?
HairlessVulcanMessage=Blue hairless vulcan perfectionists? Like, this isn't even DnD anymore
TentaclesAndMutationsMessage=OKAY YOU HAVE TENTACLES AND MUTATIONS. YOU'RE A MAD SCIENCE EXPERIMENT
GenasiMessage=GENASI (Elemental Evil)
GeniesAreElementalMessage=Genies are elemental, so pick an element
FireGenasiMessage=FIRE GENASI (Genasi Subrace)
EarthGenasiMessage=EARTH GENASI (Genasi subrace)
AirGenasiMessage=AIR GENASI (Genasi subrace)
WaterGenasiMessage=WATER GENASI (Genasi subrace)
GithMessage=GITH (MtoF)
GithComeInTwoFlavorsMessage=Not quite. Anyways Gith come in two flavors
GithyankiMessage=GITHYANKI (Gith Subrace)
GithzeraiMessage=GITHZERAI (Gith Subrace)
VedalkenMessage=VEDALKEN (GGtR)
SimicHybridMessage=SIMIC HYBRID (GGtR)
KalashtarMessage=KALASHTAR (GGtR)
BanningYouMessage=Neither do I. Also I'm banning you from my game.
GoOnAdventures=I wanna go on adventures
LordOfTheRing=Can I be someone from Lord of The Ring or something
SpecialSnowflake=I want to be a special snowflake
DontLikeFantasy=I don't like fantasy. I just wanna do this RPG thing
vampire_ans=I don't like elves, lets be vampires
ElfOrSmth=I'm an elf or something?
SwordAndMagic=What's on the inside. And my sword. And my magic
SmthDiffrent=Actually Tolkien is a hack. Gimme something DIFFERENT
MeToo=Me too!
NoTrue=I'm DARK and MISUNDERSTOOD and there's no true RIGHT or WRONG
WantToBeDragon=I want to be a dragon
NotElfDwarfETC=Uh, just make me not an elf, dwarf, angel, devil
DarkWhiteDude_yes=Yeah, I guess you're right
DarkWhiteDude_no=No, I wear the darkness on my sleeve for all the world to see
Dragon_yes=It's called Dungeons & Dragons!!!
Dragon_no=UGH... FINE...
YAY=YAY
NotDragon=This isn't a dragon
KidSized=What does this come kid-sized?
OkayFine=Okay. Fine...
NoLemmeDragon=Noooooooo lemme be a DRAGON!
NoOneGetsMe=No one gets me, especially my Mom
IWasMonster=You know what, I was the monster all along
SlaughterLaughter=Can't spell Slaughter without Laughter
Funny_Q=Do you think this is funny?
Scales_Yes=Yea
Scales_No=Nay
PowerStrength=Strength
PowerIntellect=Intellect
FaceThem=Face them head on, I'm no coward!
JustLazy=Ambushes aren't cowardly, I'm just lazy
UltimateWeapon=Deception is the ultimate weapon
TacticalProwess=Tactical prowess marks a keen mind
IDontWant=I don't want to be stupid, can I backpedal a bit and be a bit more heroic?
VersionBig=Big
VersionSmall=Small
LikeFurry=Uh, like a furry?
MoreSpecial=Gross no, I said SPECIAL
WeirdWeirdsYes=Yeah... I don't think so
WeirdWeirdsNo=... you're right. Let's stick to something at least a bit familiar
MissionFromGod=We're on a mission from God
DCsuperhero=Basically Aquaman is the best DC superhero
BeepBoopBop=Beep Boop Bop. I am Robot
Doppelganger=...can I be a Doppelganger?
ClassicMonster=Can I be a classic Monster?
AnimalPersonQuestion=Can I be an animal person?
Nuanced=Uh, just give me a touch, just enough to make it nuanced
HundredPercent=Oh, lets go 100% monster
MoreHorse=Actually more of a horse thing for me
BirdsCool=No but birds are cool
OwO=OwO
Scalie=Actually I'm a Scalie
MoreElfy=Wait, can I do this but more Elf-y?
Tieflings=NO for Tieflings!
Goodness=You know, light, goodness, yadda yadda
NameIsLord=And you will know My name is the LORD when I lay My vengeance upon thee
BadAngel=Oh I wanna be an angel but not like goody two shoes. A BAD ANGEL
IamTheDark=I'm the DARK version of some elf, dwarf or other fantasy goody
Parents=One of my parents is from a species that is thought to be brutish and cruel
LookLikeADevil=I've got sinister horns and look like a devil
LizardPerson=I am actually an emotionless lizard person
GeneralReptiles=I dunno just general reptiles I guess
Snek=Snek
ChooseDragon=A DRAGON!!!
WAAAAAIIIIT=WAAAAAIIIIT
IsLame=100% human is lame. Can I be part fantasy?
MagicalPretty=Yeah I still wanna be magical and pretty
MonsterBlood=Nah. Give me some monster blood!
MeanDwarfness=I'm strong but instead of cheery dwarfness you got mean dwarfness
ElfDark=I'm quick and lithe, like an elf but DARK
FallenFromGrace=I was once holy now I've FALLEN FROM GRACE
MoreDark=I SAID MORE DARK AND BROODING
KidSize=Kid-sized please!
NoPedo=I ain't no pedo
BigSize=... is there a Big Size?
BeGentl=Pls be gentl
Mooscles=POOMP DE MOOSCLES
FeelPretty=I feel pretty
LiftBro=Do u even lift bro?
DontLikeOPT=Uh, I don't like these options
Giant=Can I be a Giant?
NoProblem=No problem, lets move over here
NotShort=Wait, I don't want to be short
TimeToDrink=By Thorin's beard, time to drink ale and axe things!
HardynHilly=Hardy n Hilly!
StoneisStrength=Stone is Strength!
IamAngry=Neither, I'm angry and rude
ImDone=Yay I'm done!
MadeOfMagic=I'm MADE OF MAGIC
TreeHuggers=Elves ara and always be threehuggers
NoneOfThis=Wait, none of this is right
ElvesFaeries=Aren't Elves Faeries? Make me goddamn weird and Fey
Mermalds=When I said Elf I meant like, Mermaids
KindOfElfy=Can I be only KIND OF ELF-y?
DarkAndBrooding=I wanted to be Dark and Brooding
Gravitas=I would like to maintain some semblance of gravitas
MagicGlitter=EVERYTHING IS MAGIC AND GLITTER
DarkHumor=Can I have a bit of a dark humor?
offBrandHobbit=Cool, off-brand Hobbit
Hardy=Make me hardy
Nimble=Make me nimble
MagicHobbit=...is this just a magic hobbit?
Mushroom=I AM A MAGIC MUSHROOM
Toys=LETS MAKE TOYS
GoDeeper=FORGET THE TOYS WE MUST GO DEEPER
Cat=Cat! Meow!
Cow=Cow! Moo!
Elephant=Elephant... ugh...
None=...none of the others?
WannaSoar=I just wanna soar on the air majestic and free
CawCaw=Caw Caw Buddy
YeahThatWorks=Yeah that works
WillSmith=Genies? Remove that Will Smith stuff from my sight
OkayThatsPretty=Okay, that's pretty out there
UglyElves=That's just ugly elves with mind powers
Fine=Fine you got me
SpaceElves=Vulcans are just space elves. These folks are just quite ordinary in that regard
ThisIsWhatImTalkingAbout=This is what I'm talking about
Mysterious=No I want to be mysterious
CaptainPlanet=Let's Captain Planet this thing
OneRealChoice=Well, there's only one REAL choice...
RockHard=Rock Hard baby
WeAllFloat=We all float down here
Aquaman=Actually I wanted to be Aquaman
ExplodeHeads=Alright, so I can explode heads with my mind right?
WeAreImmortal=WE ARE IMMORTAL. WE ARE CONQUERERS. WE ARE GITH
ZenKungFu=Zen as calm. Kung Fu as intense. Shape chaos into reality
IDontKnowWhatThisIs=...I don't know what this is
